################################################################################
#    #                    #                  #                #                #
#    #######              #                  #                #   ##########   #
#          #       #             #           #       #####    #   #        #   #
#######    #       #             #    #   #  #       #####    #   #   #    #   #
#     #    ############################   ################    #   #   #    #   #
#     #                                                       #   #   ######   #
#    ######   #############################   #################   #            #
#         #   #                           #   #                   ##############
#    #    #   #                           #        ###########    ##############
#    ######   #        #############      #        #         #    ##############
#    #        #        #############      #        #         #    ##############
#    #        #        #############      #        #         #    ##############
#             #        #############      #        #         #    #            #
#             #        #############      #        #         #                 #
###############                           #        #         #                 #
#                     #####################        #         #    #            #
#                     #                            #         #    ##############
#                     #                            #         #                 #
#    ##########       #                      #######         #     #    ##     #
#    #        #       #                      #     #   #############     #     #
#    #        #       #       ######         #     #   #     #           #     #
#    #        #       #       ######         #               #############     #
#    #        #       #       ########                                         #
#    #        #       #          #####           ################       ########
#    #        #       #          #####           #              #       ########
#    ###   ####       #                          #              #       ########
#      #   #          #                          #                      ########
#                     #                          #                      ########
################################################################################